9393939153
AC02A8003A
83C002C6C2
AAFAAAFFFA
C6FC4057FA
93FFFAFFFA
C413FAFD52
952AFAFFFA
8386941112
C4454546C6

9,9
0,0
NWWWWNNNNWNNWWNWNW